EWEEEEEEEW
EEEWWWWWEE
EEEEEEEWEE
WWWWWWWWWW
EDEEEEEEEE
WWWEEWWWWW
EEEEEWEEWE
WWEEWEEEWE
EEEEEEEEAE
EEEEEEEEEE
