EWEEEEEEEWE
EEWEEEEAWEE
EEEEEWWWWEE
WEEEEEEEEEE
EEEEEEEEEWE
WWWEEEEEEEE
EDEWEEEEEEE
EEEEEEEWEEE
